..........
....W.....
....W.....
....W.....
....W.....
....W.....
.S..W.....
....W.....
WWWWW.E...
..........
