..........
..........
..........
..........
..........
..........
.SOOOOO...
OOOOOOO...
.OOOOOD...
..........
