.............
.............
.............
.............
.............
.............
.SOOOOO......
OOOOOOO......
.OOOOOO......
..OOOOO......
.............
......D......
.............
